capturetigg				alexandriainstruct@gmail.com
hopelesschiggle			devoncrochet@gmail.com
measlywithers			sherbrookewrite@gmail.com
hiccupcobbey			lucknowcheer@gmail.com
cloakmonks				wisconsinstash@gmail.com
tacosmalderton			singaporeuntie@gmail.com
opossumscarton			reginathaw@gmail.com
lutchettix				nottinghamshiredam@gmail.com
tightsmorleena			derbyfreeze@gmail.com
platformknag			topekasnooze@gmail.com
hesitanthexam			hartfordmend@gmail.com
invidiousmanette		nagoyalaugh@gmail.com
formfluggers			yangoncurve@gmail.com
bovrilsnigsworth		armaghlet@gmail.com
searchclarriker			canmorespin@gmail.com
planeskettles			concordrule@gmail.com
snivelingarethusa		boiseequivocate@gmail.com
toffeecurdle			whitehorsebruise@gmail.com
obviouspawkins			nanaimobob@gmail.com
freshmeagles			midlandnotice@gmail.com
agiledame				honolulutype@gmail.com
shockingsilas			buckinghamshireext@gmail.com
truepassnidge			victoriavilletry@gmail.com
rollswackford			suzhousoak@gmail.com
clifdennadgett			manilavolunteer@gmail.com
ikeaplummer				windsortempt@gmail.com
leekstrott				oklahomabellow@gmail.com
pancakecasby			vernonreceive@gmail.com
organizesoloman			dongguaninform@gmail.com
successfuldolge			johannesburggush@gmail.com
shitvholes				helenaemigrate@gmail.com
aboutbudden				albanycare@gmail.com
reevegattleton			bismarckfear@gmail.com
backcluppins			minnesotasense@gmail.com
carolredlaw				miramichidecorate@gmail.com
flippantpayne			alabamawonder@gmail.com
sodajiniwin				oxfordconnect@gmail.com
transomchowser			prestonremain@gmail.com
umpirecrimple			faisalabaddrone@gmail.com
europeansophronia		dhakacome@gmail.com
buttermilknathaniel		beijingmatter@gmail.com
oddsbloss				chennaiwander@gmail.com
parkagrompas			herefordrepeat@gmail.com
vicargroper				guangzhouwelcome@gmail.com
loudmouthnemo			brooksargue@gmail.com
appearanceakershem		saleminterject@gmail.com
roughlorry				hefeidecide@gmail.com
skyscraperdawkins		carlislefit@gmail.com
politicaltootle			hawaiistore@gmail.com
sharpnesscaddy			peterboroughexpect@gmail.com